1111121111
1        1 
1        5
1  13    4
1   5    4
1   5    4
1  13    5
1        1
1        1
2111222111