1111121111
1        3 
1        3
1        3
1   5    3
1   5    3
1  5555  3
1        3
1        3
2111222111